#############################################################################
#...........................................................................#
#...........................................................................#
#...........................................................................#
#...........................................................................#
#...........................................................................#
#...........................................................................#
#...........................................................................#
#.......######################.................######################.......#
#.......#....................#.................#....................#.......#
#.......#....................#.................#....................#.......#
#.......#...........................................................#.......#
#.......#...........................................................#.......#
#.......#....................#.................#....................#.......#
#.......######################.................######################.......#
#...........................................................................#
#.....................................#.....................................#
#.....................................#.....................................#
#.....................................#.....................................#
#...........................................................................#
#...........................................................................#
#.....#################################################################.....#
#...........................................................................#
#...........................................................................#
#...........................................................................#
#.....#################################################################.....#
#...........................................................................#
#...........................................................................#
#...........................................................................#
#############################################################################

