#############################################################################
#...........................................................................#
#...........................................................................#
#...........................................................................#
#...........................................................................#
#...........................................................................#
#...........................................................................#
#...........................................................................#
#...........................................................................#
#.............############.........#####.......###############..............#
#..............#.....................#................#.....................#
#..............#.....................#................#.....................#
#..............#.....................#................#.....................#
#..............######................#................#.....................#
#..............#.....................#................#.....................#
#..............#.....................#................#.....................#
#.............###..................#####..............#.....................#
#...........................................................................#
#...........................................................................#
#...........................................................................#
#...........................................................................#
#...........................................................................#
#...........................................................................#
#...........................................................................#
#...........................................................................#
#...........................................................................#
#...........................................................................#
#...........................................................................#
#...........................................................................#
#############################################################################

